{
  "game_dimension": {"width": 8, "height": 8},
  "blocks": [
    [0,1,0,1,1,0,1,0],
    [0,0,1,0,0,1,0,0],
    [0,0,0,0,0,0,0,0],
    [0,0,1,0,0,1,0,0],
    [1,0,0,0,1,0,0,0],
    [0,0,0,0,0,0,1,0],
    [0,0,0,1,0,1,0,0],
    [1,0,0,0,0,0,0,0]
  ]
}
